111111111111111111111
1P0000000000000000001
100000000000E00001111
100000000000000001001
1111100000000000010C1
111111111111111111111