111111111111111111111
1P0000000000000000001
10E000000000000001111
100000000000000001001
111111111111111111111